# # # # # # # # # # # # # # # # # # # # # # # # # # # # # # # # # # # # # # # # # # # # # #
#                                               # ^ #                                     #
#                                                                                         #
#                                                                                         #
#                                                                                         #
#                                                                                         #
#                                                                                         #
# # # # #     $ $                       *                                                 #
#           # # # #             # # # # # # #                         *                   #
#           #     #                                 # & #         # # # # # # #           #
#   # # # # #     # # # # #                         #   #                                 #
#   #     #         #     #                         #   # $                               #
# # # # # # # # # # # # # # # # # # # # # # # # # # #   # # # # # # # # # # # # # # # # # #